40 40
3 3 3 4 4 4 4 5 5 5 5 5 5 5 5 5 5 5 5 5 16 16 16 26 26 26 27 27 17 17 17 17 17 17 17 17 17 17 17 17
3 3 3 4 4 4 4 5 5 5 5 5 5 5 5 5 5 5 5 5 16 16 16 26 26 26 27 27 17 17 17 17 17 17 17 17 17 17 17 17
3 3 3 4 4 4 4 1 1 1 1 1 1 1 1 1 1 1 1 1 16 16 16 26 26 26 27 27 17 17 17 17 17 17 17 17 17 17 17 17
3 3 3 4 4 4 4 1 1 1 1 1 1 1 1 1 1 1 1 1 16 16 16 26 26 26 27 27 1 1 1 1 1 1 1 1 1 1 1 1
3 3 3 4 4 4 4 1 1 1 1 1 1 1 1 1 1 1 1 1 16 16 16 26 26 26 27 27 1 1 1 1 1 1 1 1 1 1 1 1
3 3 3 4 4 4 4 1 1 1 1 1 1 1 1 1 1 1 1 1 16 16 16 26 26 26 27 27 1 1 1 1 1 1 1 1 1 1 1 1
3 3 3 4 4 4 4 10 10 10 10 12 12 12 12 12 12 13 13 13 16 16 16 26 26 26 27 27 1 1 1 1 1 1 1 1 1 1 1 1
3 3 3 1 1 1 1 1 1 1 1 12 12 12 12 12 12 13 13 13 16 16 16 26 26 26 27 27 1 1 1 1 1 1 1 1 1 1 1 1
3 3 3 1 1 1 1 1 1 1 1 12 12 12 12 12 12 1 1 1 1 1 1 26 26 26 27 27 1 1 1 1 1 1 1 1 1 1 1 1
3 3 3 1 1 1 1 1 1 1 1 12 12 12 12 12 12 1 1 1 1 1 1 26 26 26 27 27 28 28 25 25 25 25 25 25 25 25 15 15
3 3 3 1 1 1 1 1 1 1 1 12 12 12 12 12 12 1 1 1 1 1 1 26 26 26 27 27 28 28 25 25 25 25 25 25 25 25 15 15
3 3 3 1 1 1 1 1 1 1 1 12 12 12 12 12 12 1 1 1 1 1 1 26 26 26 27 27 28 28 25 25 25 25 25 25 25 25 15 15
3 3 3 1 1 1 1 1 1 1 1 12 12 12 12 12 12 1 1 1 1 1 1 26 26 26 27 27 28 28 25 25 25 25 25 25 25 25 15 15
3 3 3 1 1 1 1 1 1 1 1 12 12 12 12 12 12 14 24 24 24 24 24 26 26 26 27 27 28 28 25 25 25 25 25 25 25 25 15 15
3 3 3 1 1 1 1 1 1 1 1 12 12 12 12 12 12 14 24 24 24 24 24 26 26 26 27 27 28 28 25 25 25 25 25 25 25 25 15 15
3 3 3 6 8 8 8 8 8 8 11 12 12 12 12 12 12 14 1 1 1 1 1 1 1 1 27 27 28 28 25 25 25 25 25 25 25 25 15 15
3 3 3 6 8 8 8 8 8 8 11 12 12 12 12 12 12 14 1 1 1 1 1 1 1 1 27 27 28 28 25 25 25 25 25 25 25 25 15 15
3 3 3 6 8 8 8 8 8 8 11 12 12 12 12 12 12 14 1 1 1 1 1 1 1 1 27 27 28 28 1 1 1 1 1 1 1 1 15 15
3 3 3 6 8 8 8 8 8 8 11 12 12 12 12 12 12 14 1 1 1 1 1 1 1 1 27 27 28 28 1 1 1 1 1 1 1 1 15 15
3 3 3 6 8 8 8 8 8 8 11 12 12 12 12 12 12 14 1 1 1 1 1 1 1 1 27 27 28 28 1 1 1 1 1 1 1 1 15 15
3 3 3 6 8 8 8 8 8 8 11 12 12 12 12 12 12 14 1 1 1 1 1 1 1 1 27 27 28 28 1 1 1 1 1 1 1 1 15 15
3 3 3 6 8 8 8 8 8 8 11 12 12 12 12 12 12 14 1 1 1 1 1 1 1 1 27 27 28 28 1 1 1 1 1 1 1 1 15 15
3 3 3 6 8 8 8 8 8 8 11 12 12 12 12 12 12 14 1 1 1 1 1 1 1 1 27 27 28 28 1 1 1 1 1 1 1 1 15 15
3 3 3 6 8 8 8 8 8 8 11 12 12 12 12 12 12 14 18 18 22 22 22 22 22 22 27 27 28 28 1 1 1 1 1 1 1 1 15 15
3 3 3 6 8 8 8 8 8 8 11 12 12 12 12 12 12 14 18 18 22 22 22 22 22 22 27 27 28 28 23 23 21 21 21 21 21 21 15 15
3 3 3 6 1 1 1 1 1 1 11 12 12 12 12 12 12 14 18 18 22 22 22 22 22 22 27 27 28 28 23 23 21 21 21 21 21 21 15 15
3 3 3 6 1 1 1 1 1 1 11 12 12 12 12 12 12 14 18 18 22 22 22 22 22 22 027 27 28 28 23 23 21 21 21 21 21 21 15 15
3 3 3 6 1 1 1 1 1 1 11 12 12 12 12 12 12 14 18 18 1 1 1 1 1 1 1 1 1 1 1 1 21 21 21 21 21 21 15 15
3 3 3 6 1 1 1 1 1 1 11 12 12 12 12 12 12 14 18 18 1 1 1 1 1 1 1 1 1 1 1 1 21 21 21 21 21 21 15 15
3 3 3 6 1 1 1 1 1 1 11 12 12 12 12 12 12 14 18 18 1 1 1 1 1 1 1 1 1 1 1 1 21 21 21 21 21 21 15 15
3 3 3 6 1 1 1 1 1 1 11 12 12 12 12 12 12 14 18 18 1 1 1 1 1 1 1 1 1 1 1 1 21 21 21 21 21 21 15 15
3 3 3 6 7 7 7 7 7 7 11 12 12 12 12 12 12 14 18 18 19 19 20 20 20 20 20 20 20 20 20 20 21 21 21 21 21 21 15 15
3 3 3 6 7 7 7 7 7 7 11 12 12 12 12 12 12 14 18 18 19 19 20 20 20 20 20 20 20 20 20 20 21 21 21 21 21 21 15 15
3 3 3 6 7 7 7 7 7 7 1 1 1 1 1 1 1 1 1 1 1 1 20 20 20 20 20 20 20 20 20 20 21 21 21 21 21 21 15 15
3 3 3 6 7 7 7 7 7 7 1 1 1 1 1 1 1 1 1 1 1 1 20 20 20 20 20 20 20 20 20 20 21 21 21 21 21 21 15 15
3 3 3 6 7 7 7 7 7 7 1 1 1 1 1 1 1 1 1 1 1 1 20 20 20 20 20 20 20 20 20 20 21 21 21 21 21 21 15 15
3 3 3 6 7 7 7 7 7 7 9 9 9 9 9 9 9 9 9 9 9 9 20 20 20 20 20 20 20 20 20 20 21 21 21 21 21 21 15 15
3 3 3 6 7 7 7 7 7 7 9 9 9 9 9 9 9 9 9 9 9 9 20 20 20 20 20 20 20 20 20 20 21 21 21 21 21 21 15 15
3 3 3 6 7 7 7 7 7 7 9 9 9 9 9 9 9 9 9 9 9 9 20 20 20 20 20 20 20 20 20 20 21 21 21 21 21 21 15 15
3 3 3 6 7 7 7 7 7 7 9 9 9 9 9 9 9 9 9 9 9 9 20 20 20 20 20 20 20 20 20 20 21 21 21 21 21 21 15 15
