16 16
0 0 0 0 2 2 2 2 3 3 3 3 4 4 4 4
0 0 0 0 2 2 2 2 3 3 3 3 4 4 4 4
0 0 0 0 2 2 2 2 3 3 3 3 4 4 4 4
0 0 0 0 2 2 2 2 3 3 3 3 4 4 4 4
0 0 0 0 2 2 2 2 3 3 3 3 1 1 1 1
0 0 0 0 2 2 2 2 3 3 3 3 1 1 1 1
0 0 0 0 2 2 2 2 3 3 3 3 1 1 1 1
0 0 0 0 2 2 2 2 3 3 3 3 1 1 1 1
0 0 0 0 2 2 2 2 1 1 1 1 1 1 1 1
0 0 0 0 2 2 2 2 1 1 1 1 1 1 1 1
0 0 0 0 2 2 2 2 1 1 1 1 1 1 1 1
0 0 0 0 2 2 2 2 1 1 1 1 1 1 1 1
0 0 0 0 1 1 1 1 1 1 1 1 1 1 1 1
0 0 0 0 1 1 1 1 1 1 1 1 1 1 1 1
0 0 0 0 1 1 1 1 1 1 1 1 1 1 1 1
0 0 0 0 1 1 1 1 1 1 1 1 1 1 1 1